*********
*    *  *
*       *
*    ****
*    ****
**      *
E       *
*   S   *
*********
